R 1000 600

NO ./res/wall_1.xpm
SO ./res/bluestone.xpm
WE ./res/wood.xpm
EA ./res/purplestone.xpm
S ./res/pillar.xpm
S2 ./res/sprite_1.xpm

C 200,200,230
F 100,15,110


1 1 1 1 1 1 1 1 1 1 1 1 1 1 1 1 1 1 1 1 1 1 1 1 1
1 0 0 0 0 0 0 0 0 0 1 1 0 0 0 0 0 0 0 0 0 0 0 0 1
1 0 1 1 0 0 0 0 0 1 1 1 0 2 0 0 0 2 0 0 0 0 2 0 1
1 0 0 1 0 0 2 0 0 0 0 0 0 0 0 0 0 0 0 0 0 0 0 0 1
1 0 1 1 0 0 0 0 0 1 1 1 0 0 0 0 0 0 0 0 0 0 0 0 1
1 0 0 0 0 0 0 0 0 0 1 1 0 0 0 0 0 1 1 1 0 1 1 1 1
1 1 1 1 0 0 1 1 1 1 1 1 1 1 1 1 1 1 0 0 0 0 0 0 1
1 1 1 1 0 0 1 1 0 0 1 1 1 1 1 1 1 1 0 0 0 0 0 0 1
1 1 0 0 0 0 0 0 0 0 0 1 0 1 0 0 0 1 0 0 0 3 0 0 1
1 0 0 0 0 3 0 0 0 0 0 0 0 0 0 0 0 1 0 0 0 0 0 0 1
1 0 0 0 0 0 0 0 0 0 0 0 0 0 0 2 0 1 0 0 0 0 0 0 1
1 1 0 0 0 0 0 0 1 1 0 1 1 1 0 0 0 1 1 1 0 1 1 1 1
1 1 1 1 1 1 1 1 1 1 1 1 0 0 0 0 1 1 1 1 0 1 1 1 1
1 1 1 1 1 1 1 1 1 1 1 1 0 0 0 0 0 1 0 0 0 0 0 0 1
1 1 0 0 0 0 0 1 1 1 0 0 0 3 0 0 0 1 0 0 0 0 0 0 1
1 0 0 0 0 0 0 0 1 1 0 0 0 0 0 0 0 1 0 3 0 0 0 0 1
1 0 0 0 0 0 0 0 1 1 1 1 1 1 0 N 0 1 1 0 0 0 1 0 1
1 0 2 0 0 0 0 0 1 1 1 1 1 1 1 1 1 1 1 1 0 1 1 1 1
1 0 0 0 0 0 0 1 1 1 0 0 0 1 1 1 1 1 0 0 0 0 0 0 1
1 0 0 0 0 0 0 0 1 0 0 0 0 0 1 1 0 1 0 0 0 2 0 0 1
1 0 0 0 0 0 0 0 0 0 0 3 0 0 0 0 0 0 0 0 0 0 0 0 1
1 0 0 0 0 0 0 0 1 0 0 0 0 0 1 1 0 1 0 0 0 0 0 0 1
1 1 0 0 3 0 0 1 1 1 0 0 0 1 1 1 1 1 1 0 0 0 1 1 1
1 1 0 0 0 0 0 1 1 1 0 0 0 1 1 1 1 1 1 0 0 0 1 1 1
1 1 1 1 1 1 1 1 1 1 1 1 1 1 1 1 1 1 1 1 1 1 1 1 1
